15
30
MMMMMMMMMMMMMMMMMMMMMMMMMMMMMM
M                            M
M I     E                    M
M E                          M
M                            M
M    L                       M
M                            M
M                            M
ME                           M
M                            M
M                            M
M          I                 M
M      I                     M
M                            M
MMMMMMMMMMMMMMMMMMMMMMMMMMMMMM